50 50
@3@5#0@3@3#0@3@3#0@3@3@3#0@3@3@3@3@3#0@3@3@3@3@3@3#0#0@3@3@3#0@3@3@3@3@3@3@3@3#0@3@3@3@3@3@3@3@3@3@3
@4@3#0@3@3#0@3@3#0@3@5@3#0#0@3@4@3@3#0@4@3@3@3#0#0#0#0#0#0#0#0#0#0#0#0#0#0#0#0#0#0#0#0#0#0#0#0#0#0#0
#0#0#0#0#0#0#0#0#0#0#0#0#0@3#0@3@3@3#0@3@3@3#0@3@3#0#0@3@3@3#0@3@3@3@4@3@3@3@3#0@3@4@3@3@5@3#0@4@3#0
@3@3#0@4@3#0@3@3#0@4@3@3#0@3@3#0@3@4#0@5@3#0@5@3@3#0#0@3@4@3#0@3@5@5@3@3@4@3@3#0@3@3@5@3@3@3#0@4@5#0
@3@5#0@3@3#0@3@3#0@3@4@3#0@3@3@3#0@3#0@3#0@3@6@3@3#0#0@3@4@3#0@4@5@5@3#0#0#0#0#0#0#0#0#0#0#0#0#0#0#0
#0#0#0#0#0#0#0#0#0#0#0#0#0@3@3@3@3#0#0#0@6@3@4@3@3#0#0@5@4@3#0@4@6@5@3#0'0'0'0'0'0'0'0#0@3@3#0@3@3#0
@3@3#0@3@3#0@5@3#0@5@5@3#0#0#0#0#0#0#0#0#0#0#0#0#0#0#0@3@4@3#0@4@5@5@4#0'0"0"0"0"0"0'0#0@5@3#0@5@3#0
@3@5#0@5@3#0@3@5#0@3@3@3#0@5@3@3@3#0#0#0@3@3@3@4@3#0#0@4@4@3#0@3@3@3@3#0'0"0"0~1"0.0'0#0@3@4#0@5@5#0
#0#0#0#0#0#0#0#0#0#0#0#0#0@6@4@3#0@3#0@3#0@3@3@3@3#0#0#0#0#0#0#0#0#0#0#0'0.0~1~1~1.0'0#0@3@3#0@5@3#0
@3@3#0@3@3#0@3@3#0@3@3@3#0@5@3#0@3@3#0@3@3#0@5@3@3#0#0@5@3@3#0@3@3@3@4#0'0.0"0~1~1.0'0#0@4@3#0@3@3#0
@3@4#0@3@3#0@3@3#0@4@6@5#0@3#0@3@3@3#0@3@3@3#0@3@3#0#0@3@5@3#0@3@5@5@3#0'0.0.0.0.0.0'0#0#0#0#0#0#0#0
#0#0#0#0#0#0#0#0#0#0#0#0#0#0#0#0#0#0#0#0#0#0#0#0#0#0#0@3@4@4#0@4@5@5@3#0'0'0'0'0'0'0'0#0@3@3#0@5@3#0
@4@3#0@3@4@3@5@4@3#0@3@3#0@3@3#0@3@3#0@3@4@3@3@4@3#0#0@5@4@3#0@3@5@3@3#0#0#0#0#0#0#0#0#0@4@3#0@6@5#0
@3@5#0@5@3@4@3@6@4#0@4@3#0@4@3#0@4@3#0@3@3@3@3@3@3#0#0@3@4@4#0@3@3@4#0#0@3@3@3#0@3@3@3@3@3@3#0@5@3#0
#0#0#0#0#0#0#0#0#0#0#0#0#0@3@3#0@3@3#0#0#0#0@3@3@3#0#0@3@4@3#0@3@3#0#0@3@5@5@3#0@3@5@3@3@4@3#0@3@3#0
@3@5#0@3@4@3@4@3@3#0@3@3#0@3@3@4@3@3#0@3@3@3@4@3@3#0#0@6@4@3#0@3#0#0@3@5@5@5@3#0@3@5@3#0@3@3#0@3@4#0
@3@3#0@5@5@3@3@3@4#0@5@3#0@4@3@3@5@3#0@4@3@3@3@4@3#0#0@3@4@4#0#0#0@3@3@3@3#0@3#0@3@3@3#0@3@4#0@4@4#0
@4@3#0#0#0#0#0#0#0#0#0#0#0#0#0#0#0#0#0#0#0#0#0#0#0#0#0@7@4@3#0#0#0#0#0#0#0#0#0#0#0#0#0#0#0#0#0#0#0#0
@3@3#0@3@4@3@3@4@3#0@3@3#0@3@4@3@3@3#0@3@4#0@3@3@3#0#0@5@3#0#0@4@3@3@3@6@6@5@5#0@3@4@4@3@3@3#0@4@4#0
@3@4#0@3@3@5@3@3@3#0@4@3#0@3@3@3@4@3#0@3@3#0@4@3@3#0#0@3#0#0@4@4@3@3@3@6@6@5@5#0@3@3@4@3@3@4#0@4@4#0
@3@3#0@3#0#0#0@3@3#0@3@3#0@5@3#0#0#0#0@4@3#0@3@4@3#0#0#0#0#0#0#0#0#0#0#0#0#0#0#0#0#0#0#0#0#0#0#0#0#0
@5@4#0@4#0#0#0@3@3#0@3@4#0@3@3@3@3@3#0@3@3@3@3@3@3#0#0#0#0@5@4@3@3@3@3@3@3@353#0@3@4@3@3@4@3#0@3@3#0
@3@3#0@3@3#0@3@3@3#0@4@3#0@3@4@3@3@3#0@3@4@3@6@3@5#0#0@6@6@5@4@3@3@4@5@3@353@3#0@5@5@5@5@5@3#0@6@5#0
@4@3#0@5@3#0@3@5@3#0@3@3#0@3@3@3@4@3#0@4@3@3@7@5@7#0#0@7@6@5@4@3@4@3@3@5@3@3@3#0@3@6@3@4@7@3#0@3@3#0
#0#0#0#0#0#0#0#0#0#0#0#0#0#0#0#0#0#0#0#0#0#0#0#0#0#0#0#0#0#0#0#0#0#0#0#0#0#0#0#0#0#0#0#0#0#0#0#0#0#0
#0#0#0#0#0#0#0#0#0#0#0#0#0#0#0#0#0#0#0#0#0#0#0#0#0#0#0#0#0#0#0#0#0#0#0#0#0#0#0#0#0#0#0#0#0#0#0#0#0#0
@3@3@3#0@3@3@3@3@3@3@3@3#0@3@3@3@3@3@3@3@3#0@3@4@4#0#0@8@8#0@8@8#0@3@3#0@3@3#0@3@3#0@3@3#0@4@5#0@6@6
@3@3@3#0@3@3@3@3@3@3@3@3#0@3@3@3@3@3@3@3@3#0@3@4@4#0#0@8@8#0@8@8#0@3@3#0@3@3#0@3@3#0@3@3#0@5@3#0@6@8
@3@3#0#0#0#0#0#0#0#0#0#0#0#0#0#0#0#0#0#0#0#0#0@3@3#0#0@8@8#0@8@8#0@3@3#0@3@3#0@3@3#0@3@3#0@3@3#0@6@6
#0#0#0@3@3@3#0@3@3@3@3@3#0@3@3@3@3@3#0@3@3@3#0#0#0#0#0#0#0#0#0#0#0#0#0#0#0#0#0#0#0#0#0#0#0#0#0#0#0#0
@3@3#0@3@3@3#0@3@3@3@3@3#0@3@3@3@3@3#0@3@3@3#0@3@3#0#0@6@3#0@3@5#0@3@3#0@3@3#0@5@3#0@3@3#0@4@3#0@3@3
@3@3#0@3@3#0#0#0#0#0#0#0#0#0#0#0#0#0#0#0@3@3#0@3@3#0#0@3@4#0@3@3#0@3@4#0@4@3#0@3@3#0@4@3#0@5@3#0@5@4
@3@3#0#0#0#0@3@3@3#0@3@3#0@3@3#0@3@3@3#0#0#0#0@3@3#0#0#0#0#0#0#0#0#0#0#0#0#0#0#0#0#0#0#0#0#0#0#0#0#0
@3@3#0@3@3#0@3@3@3#0@3@3#0@3@3#0@3@3@3#0@3@3#0@3@3#0#0@3@5#0@3@4#0@3@6#0@3@3#0@5@3#0@3@4#0@3@3#0@3@3
@3@3#0@3@3#0@3@3#0#0#0#0#0#0#0#0#0@3@3#0@3@3#0@3@3#0#0@6@3#0@5@3#0@4@3#0@6@3#0@3@3#0@5@3#0@3@3#0@3@3
@3@3#0@3@3#0#0#0#0@3@3@3#0@3@3@3#0#0#0#0@3@3#0@3@3#0#0#0#0#0#0#0#0#0#0#0#0#0#0#0#0#0#0#0#0#0#0#0#0#0
@3@3#0@3@3#0@3@3#0@3@3@3#0@3@3@3#0@3@3#0@3@3#0@3@3#0#0@5@3#0@3@3#0@3@3#0@3@3#0@3@3#0@4@3#0@5@3#0@3@3
@3@3#0@3@3#0@3@3#0@3@3#0#0#0@3@3#0@3@3#0@3@3#0@3@3#0#0@3@3#0@4@3#0@3@3#0@5@3#0@4@3#0@6@3#0@7@3#0@3@3
@3#0#0#0#0#0#0#0#0#0#0#0~1#0#0#0#0#0#0#0#0#0#0#0@3#0#0#0#0#0#0#0#0#0#0#0#0#0#0#0#0#0#0#0#0#0#0#0#0#0
@3@3#0@3@3#0@3@3#0@3@3#0#0#0@3@3#0@3@3#0@3@3#0@3@3#0#0@3@3#0@3@3#0@4@3#0@3@5#0@3@3#0@3@3#0@3@4#0@3@3
@3@3#0@3@3#0@3@3#0@3@3@3#0@3@3@3#0@3@3#0@3@3#0@3@3#0#0@4@3#0@3@3#0@3@4#0@3@3#0@4@3#0@3@3#0@3@3#0@4@3
@3@3#0@3@3#0#0#0#0@3@3@3#0@3@3@3#0#0#0#0@3@3#0@3@3#0#0#0#0#0#0#0#0#0#0#0#0#0#0#0#0#0#0#0#0#0#0#0#0#0
@3@3#0@3@3#0@3@3#0#0#0#0#0#0#0#0#0@3@3#0@3@3#0@3@3#0#0@3@5#0@3@3#0@3@3#0@3@4#0@3@3#0@3@3#0@3@3#0@3@3
@3@3#0@3@3#0@3@3@3#0@3@3#0@3@3#0@3@3@3#0@3@3#0@3@3#0#0@3@4#0@5@3#0@4@3#0@3@3#0@4@3#0@5@4#0@3@3#0@3@4
@3@3#0#0#0#0@3@3@3#0@3@3#0@3@3#0@3@3@3#0#0#0#0@3@3#0#0#0#0#0#0#0#0#0#0#0#0#0#0#0#0#0#0#0#0#0#0#0#0#0
@3@3#0@3@3#0#0#0#0#0#0#0#0#0#0#0#0#0#0#0@3@3#0@3@3#0#0@3@3#0@3@4#0@3@3#0@4@5#0@3@3#0@5@3#0@3@4#0@3@3
@3@3#0@3@3@3#0@3@3@3@3@3#0@3@3@3@3@3#0@3@3@3#0@3@3#0#0@4@3#0@4@3#0@4@4#0@3@3#0@4@3#0@3@3#0@5@3#0@4@3
#0#0#0@3@3@3#0@3@3@3@3@3#0@3@3@3@3@3#0@3@3@3#0#0#0#0#0#0#0#0#0#0#0#0#0#0#0#0#0#0#0#0#0#0#0#0#0#0#0#0
@3@3#0#0#0#0#0#0#0#0#0#0#0#0#0#0#0#0#0#0#0#0#0@3@3#0#0@5@3#0@3@3#0@5@3#0@3@3#0@3@5#0@3@3#0@5@5#0@3@4
@3@3@3#0@3@3@3@3@3@3@3@3#0@3@3@3@3@3@3@3@3#0@3@3@3#0#0@3@3#0@5@3#0@3@3#0@4@4#0@3@3#0@5@3#0@3@3#0@3@4
-1
-1 -1 -1 -1 